
OK			Enter
Back			Esc
Up			k
UpAndLeft		y
Left			h
DownAndLeft		b
Down			j
DownAndRight	        n
Right			l
UpAndRight		u
ScrollUp		-
ScrollDown		+
ScrollDown		=

Help			?
Look			/
Save			S
Char			c
Buy			$

Wait			.
FloorUp		>
FloorDown		<
Strafe		z
StrafeLock		Z
Turn			x
TurnLock		X
Get			,
Operate		Space
Armour		a
Sidearm		s
Primary		p
Reload		o
Drop			d
Fire			f
Frag			r
Stun			t
Inc			i
Krak			g
Medkit		m
Neutraliser		v
Demolition		e
